name,ea,size,in_degree,out_degree,degree,binary
FUN_0001cc58,117848,16,51,0,51,MAIN.EXE
thunk_FUN_0001f5d4,128448,8,32,0,32,MAIN.EXE
FUN_000090e0,37088,1104,0,31,31,MAIN.EXE
FUN_0001f5e8,128488,40,22,0,22,MAIN.EXE
FUN_0001d600,120320,284,18,2,20,MAIN.EXE
FUN_00008528,34088,1884,0,18,18,MAIN.EXE
FUN_0002273c,141116,2388,1,16,17,MAIN.EXE
FUN_0000a944,43332,456,0,14,14,MAIN.EXE
FUN_0000af3c,44860,3080,0,13,13,MAIN.EXE
FUN_00018a0c,100876,564,0,13,13,MAIN.EXE
FUN_00018dac,101804,404,2,11,13,MAIN.EXE
FUN_00035554,218452,1,13,0,13,MAIN.EXE
FUN_000235d4,144852,840,1,10,11,MAIN.EXE
FUN_0001a804,108548,616,0,11,11,MAIN.EXE
FUN_00008ce4,36068,368,0,11,11,MAIN.EXE
FUN_0000c1b0,49584,308,0,11,11,MAIN.EXE
FUN_000099ac,39340,244,0,11,11,MAIN.EXE
FUN_00009708,38664,608,0,10,10,MAIN.EXE
FUN_00019ec0,106176,468,5,5,10,MAIN.EXE
FUN_0000d208,53768,368,0,10,10,MAIN.EXE
FUN_0002db70,187248,20,10,0,10,MAIN.EXE
FUN_00023390,144272,16,9,1,10,MAIN.EXE
FUN_000246d8,149208,4,10,0,10,MAIN.EXE
FUN_0001003c,65596,1372,0,9,9,MAIN.EXE
FUN_0001fab8,129720,764,1,8,9,MAIN.EXE
FUN_000171fc,94716,712,0,9,9,MAIN.EXE
FUN_0000c490,50320,704,0,9,9,MAIN.EXE
FUN_0000e820,59424,384,0,9,9,MAIN.EXE
FUN_000083ac,33708,332,0,9,9,MAIN.EXE
FUN_00008ff0,36848,240,0,9,9,MAIN.EXE
FUN_0000cd04,52484,140,0,9,9,MAIN.EXE
FUN_0002db84,187268,20,9,0,9,MAIN.EXE
FUN_000174c4,95428,1036,0,8,8,MAIN.EXE
FUN_00016f7c,94076,648,0,8,8,MAIN.EXE
FUN_00005f78,24440,216,0,8,8,MAIN.EXE
FUN_00018fbc,102332,132,1,7,8,MAIN.EXE
FUN_0001cb60,117600,24,8,0,8,MAIN.EXE
FUN_0001cc08,117768,16,8,0,8,MAIN.EXE
FUN_0001dca4,122020,12,8,0,8,MAIN.EXE
FUN_000139a0,80288,1220,0,7,7,MAIN.EXE
FUN_0000e1a8,57768,624,0,7,7,MAIN.EXE
FUN_00020c14,134164,496,0,7,7,MAIN.EXE
FUN_00017b68,97128,480,0,7,7,MAIN.EXE
FUN_0001deb4,122548,332,0,7,7,MAIN.EXE
FUN_0000a34c,41804,280,0,7,7,MAIN.EXE
FUN_00008ebc,36540,256,0,7,7,MAIN.EXE
FUN_0002233c,140092,252,4,3,7,MAIN.EXE
FUN_0001fdb4,130484,204,0,7,7,MAIN.EXE
FUN_0002f158,192856,188,5,2,7,MAIN.EXE
FUN_00019218,102936,128,0,7,7,MAIN.EXE
FUN_000188b4,100532,40,6,1,7,MAIN.EXE
FUN_0001dd04,122116,40,6,1,7,MAIN.EXE
FUN_0002ddf4,187892,36,7,0,7,MAIN.EXE
FUN_0002df80,188288,24,7,0,7,MAIN.EXE
FUN_0001ca04,117252,16,7,0,7,MAIN.EXE
FUN_0001cc38,117816,12,6,1,7,MAIN.EXE
FUN_0002dfc4,188356,4,7,0,7,MAIN.EXE
FUN_0002e0c8,188616,1,7,0,7,MAIN.EXE
FUN_00035094,217236,1,7,0,7,MAIN.EXE
FUN_0000bdd4,48596,692,0,6,6,MAIN.EXE
FUN_00009f08,40712,360,0,6,6,MAIN.EXE
FUN_0002ecc4,191684,352,4,2,6,MAIN.EXE
FUN_0000292c,10540,272,0,6,6,MAIN.EXE
FUN_000240a0,147616,260,3,3,6,MAIN.EXE
FUN_0001b364,111460,256,1,5,6,MAIN.EXE
FUN_0000a4f0,42224,252,0,6,6,MAIN.EXE
FUN_0000d058,53336,252,0,6,6,MAIN.EXE
FUN_000239b0,145840,236,3,3,6,MAIN.EXE
FUN_0000a6f4,42740,224,0,6,6,MAIN.EXE
FUN_0001aaec,109292,144,1,5,6,MAIN.EXE
FUN_0001c7fc,116732,64,5,1,6,MAIN.EXE
FUN_0001c85c,116828,64,6,0,6,MAIN.EXE
FUN_00021dec,138732,52,5,1,6,MAIN.EXE
FUN_0001c89c,116892,48,3,3,6,MAIN.EXE
FUN_0001c9f4,117236,16,6,0,6,MAIN.EXE
FUN_0001cc68,117864,12,6,0,6,MAIN.EXE
FUN_00035360,217952,4,6,0,6,MAIN.EXE
FUN_00035464,218212,1,6,0,6,MAIN.EXE
FUN_00014f80,85888,1324,0,5,5,MAIN.EXE
FUN_00002f34,12084,1272,0,5,5,MAIN.EXE
FUN_0000f85c,63580,1156,0,5,5,MAIN.EXE
FUN_0000db18,56088,940,0,5,5,MAIN.EXE
FUN_0000fcec,64748,836,0,5,5,MAIN.EXE
FUN_000011d0,4560,624,0,5,5,MAIN.EXE
FUN_00001724,5924,560,0,5,5,MAIN.EXE
FUN_000180bc,98492,536,0,5,5,MAIN.EXE
FUN_00003454,13396,504,0,5,5,MAIN.EXE
FUN_00023d74,146804,476,0,5,5,MAIN.EXE
FUN_00020a54,133716,448,0,5,5,MAIN.EXE
FUN_000230a8,143528,324,0,5,5,MAIN.EXE
FUN_0000a234,41524,280,0,5,5,MAIN.EXE
FUN_0000ce04,52740,212,0,5,5,MAIN.EXE
FUN_0001b110,110864,204,0,5,5,MAIN.EXE
FUN_0000a7d4,42964,200,0,5,5,MAIN.EXE
FUN_0001db9c,121756,200,0,5,5,MAIN.EXE
FUN_0001215c,74076,192,0,5,5,MAIN.EXE
FUN_0001a558,107864,188,2,3,5,MAIN.EXE
FUN_00022578,140664,164,1,4,5,MAIN.EXE
FUN_00033164,209252,144,5,0,5,MAIN.EXE
FUN_00012d98,77208,112,0,5,5,MAIN.EXE
FUN_00018cf8,101624,96,2,3,5,MAIN.EXE
FUN_0002269c,140956,80,1,4,5,MAIN.EXE
FUN_0001a440,107584,60,5,0,5,MAIN.EXE
FUN_0002391c,145692,52,3,2,5,MAIN.EXE
FUN_0001c83c,116796,32,2,3,5,MAIN.EXE
FUN_00021fd4,139220,32,5,0,5,MAIN.EXE
FUN_0001dcd4,122068,28,5,0,5,MAIN.EXE
FUN_0001a4a0,107680,24,5,0,5,MAIN.EXE
FUN_0002db5c,187228,4,5,0,5,MAIN.EXE
FUN_00038674,231028,4,5,0,5,MAIN.EXE
FUN_00024bbc,150460,1,5,0,5,MAIN.EXE
FUN_00028ca4,167076,1,5,0,5,MAIN.EXE
FUN_00035324,217892,1,5,0,5,MAIN.EXE
FUN_000197bc,104380,1756,0,4,4,MAIN.EXE
FUN_000132c0,78528,708,0,4,4,MAIN.EXE
FUN_00001b90,7056,640,0,4,4,MAIN.EXE
FUN_0000d8d4,55508,580,0,4,4,MAIN.EXE
FUN_00018424,99364,488,0,4,4,MAIN.EXE
FUN_00014380,82816,404,0,4,4,MAIN.EXE
FUN_00017d48,97608,360,0,4,4,MAIN.EXE
FUN_00023f50,147280,336,2,2,4,MAIN.EXE
FUN_000026f4,9972,324,0,4,4,MAIN.EXE
FUN_0001bff4,114676,312,0,4,4,MAIN.EXE
FUN_00021ff4,139252,296,0,4,4,MAIN.EXE
FUN_0000cf48,53064,272,0,4,4,MAIN.EXE
FUN_0001ea04,125444,272,3,1,4,MAIN.EXE
FUN_0000d438,54328,252,0,4,4,MAIN.EXE
FUN_0001ce0c,118284,244,0,4,4,MAIN.EXE
FUN_0001e314,123668,240,2,2,4,MAIN.EXE
FUN_00012cb0,76976,232,0,4,4,MAIN.EXE
FUN_0001d9f4,121332,220,1,3,4,MAIN.EXE
FUN_00022234,139828,216,0,4,4,MAIN.EXE
FUN_0001ed70,126320,176,1,3,4,MAIN.EXE
FUN_0001ba1c,113180,168,0,4,4,MAIN.EXE
FUN_00005d68,23912,152,0,4,4,MAIN.EXE
FUN_0001f610,128528,144,3,1,4,MAIN.EXE
FUN_00019134,102708,132,0,4,4,MAIN.EXE
FUN_0001e1f4,123380,116,4,0,4,MAIN.EXE
FUN_000080e8,33000,112,0,4,4,MAIN.EXE
FUN_00023438,144440,112,1,3,4,MAIN.EXE
FUN_00016228,90664,108,0,4,4,MAIN.EXE
FUN_0001e268,123496,108,0,4,4,MAIN.EXE
FUN_00021c64,138340,108,3,1,4,MAIN.EXE
FUN_000186c0,100032,104,0,4,4,MAIN.EXE
FUN_000182d4,99028,100,3,1,4,MAIN.EXE
FUN_0001a734,108340,96,2,2,4,MAIN.EXE
FUN_0001de58,122456,92,1,3,4,MAIN.EXE
FUN_000211ac,135596,92,2,2,4,MAIN.EXE
FUN_00009dec,40428,88,0,4,4,MAIN.EXE
FUN_0000caf8,51960,88,0,4,4,MAIN.EXE
FUN_0001a4d0,107728,88,0,4,4,MAIN.EXE
FUN_000245b4,148916,80,4,0,4,MAIN.EXE
FUN_0002252c,140588,76,1,3,4,MAIN.EXE
FUN_0000bd44,48452,68,0,4,4,MAIN.EXE
FUN_0001b1dc,111068,68,0,4,4,MAIN.EXE
FUN_0001dd78,122232,68,3,1,4,MAIN.EXE
FUN_0000e508,58632,56,0,4,4,MAIN.EXE
FUN_00021b4c,138060,56,3,1,4,MAIN.EXE
FUN_0002230c,140044,48,1,3,4,MAIN.EXE
FUN_00019ef4,106228,36,3,1,4,MAIN.EXE
FUN_0001dd34,122164,32,3,1,4,MAIN.EXE
FUN_00018d90,101776,28,2,2,4,MAIN.EXE
FUN_0001e150,123216,28,3,1,4,MAIN.EXE
FUN_0002e77c,190332,28,4,0,4,MAIN.EXE
FUN_0001ca44,117316,16,4,0,4,MAIN.EXE
FUN_0001cba8,117672,16,4,0,4,MAIN.EXE
FUN_0001a2a0,107168,12,3,1,4,MAIN.EXE
FUN_000245a8,148904,12,4,0,4,MAIN.EXE
FUN_0001c974,117108,8,4,0,4,MAIN.EXE
FUN_0001cb98,117656,8,4,0,4,MAIN.EXE
FUN_0002c1c0,180672,8,4,0,4,MAIN.EXE
FUN_0002e148,188744,4,4,0,4,MAIN.EXE
FUN_00035cc0,220352,4,4,0,4,MAIN.EXE
FUN_00036d20,224544,4,4,0,4,MAIN.EXE
FUN_000350b4,217268,1,4,0,4,MAIN.EXE
FUN_0003539c,218012,1,4,0,4,MAIN.EXE
FUN_00036b44,224068,1,4,0,4,MAIN.EXE
FUN_00003cf0,15600,4716,0,3,3,MAIN.EXE
FUN_000114a4,70820,1412,0,3,3,MAIN.EXE
FUN_000200b4,131252,828,0,3,3,MAIN.EXE
FUN_0001f7cc,128972,748,3,0,3,MAIN.EXE
FUN_0001245c,74844,640,0,3,3,MAIN.EXE
FUN_0001cfcc,118732,636,0,3,3,MAIN.EXE
FUN_0001e7b4,124852,592,1,2,3,MAIN.EXE
FUN_00032f2c,208684,568,3,0,3,MAIN.EXE
FUN_0001fe80,130688,564,0,3,3,MAIN.EXE
FUN_00015e80,89728,548,0,3,3,MAIN.EXE
FUN_00006050,24656,464,0,3,3,MAIN.EXE
FUN_0001c5d8,116184,432,0,3,3,MAIN.EXE
FUN_0001d2a4,119460,352,0,3,3,MAIN.EXE
FUN_00002434,9268,336,0,3,3,MAIN.EXE
FUN_0000c750,51024,336,0,3,3,MAIN.EXE
FUN_0000c8a0,51360,336,0,3,3,MAIN.EXE
FUN_000204e4,132324,336,1,2,3,MAIN.EXE
FUN_00008158,33112,332,0,3,3,MAIN.EXE
FUN_000165f4,91636,332,0,3,3,MAIN.EXE
FUN_00006220,25120,328,0,3,3,MAIN.EXE
FUN_0000ae1c,44572,288,0,3,3,MAIN.EXE
FUN_00003a64,14948,280,0,3,3,MAIN.EXE
FUN_0000d7d8,55256,252,0,3,3,MAIN.EXE
FUN_00022144,139588,240,2,1,3,MAIN.EXE
FUN_00000edc,3804,232,0,3,3,MAIN.EXE
FUN_0000a628,42536,204,0,3,3,MAIN.EXE
FUN_00019040,102464,200,0,3,3,MAIN.EXE
FUN_0001aef0,110320,196,0,3,3,MAIN.EXE
FUN_0001e404,123908,188,1,2,3,MAIN.EXE
FUN_0002928c,168588,184,3,0,3,MAIN.EXE
FUN_000187c4,100292,180,1,2,3,MAIN.EXE
FUN_00021e28,138792,152,2,1,3,MAIN.EXE
FUN_0001616c,90476,144,0,3,3,MAIN.EXE
FUN_0000ca6c,51820,140,0,3,3,MAIN.EXE
FUN_0000a8c0,43200,132,0,3,3,MAIN.EXE
FUN_0000cb7c,52092,132,0,3,3,MAIN.EXE
FUN_0001bf70,114544,132,0,3,3,MAIN.EXE
FUN_00009e80,40576,120,0,3,3,MAIN.EXE
FUN_0001a2b0,107184,112,2,1,3,MAIN.EXE
FUN_0001ab94,109460,104,1,2,3,MAIN.EXE
FUN_00020ea0,134816,104,1,2,3,MAIN.EXE
FUN_00003738,14136,88,0,3,3,MAIN.EXE
FUN_00019324,103204,88,0,3,3,MAIN.EXE
FUN_0000ad2c,44332,76,0,3,3,MAIN.EXE
FUN_00040030,262192,72,3,0,3,MAIN.EXE
FUN_00018878,100472,60,2,1,3,MAIN.EXE
FUN_0000a174,41332,56,0,3,3,MAIN.EXE
FUN_000233dc,144348,52,1,2,3,MAIN.EXE
FUN_0000e548,58696,48,0,3,3,MAIN.EXE
FUN_0001ec90,126096,48,1,2,3,MAIN.EXE
FUN_0002c200,180736,48,3,0,3,MAIN.EXE
FUN_0002d96c,186732,44,3,0,3,MAIN.EXE
FUN_0002261c,140828,40,1,2,3,MAIN.EXE
FUN_00023344,144196,40,2,1,3,MAIN.EXE
FUN_00023410,144400,40,2,1,3,MAIN.EXE
FUN_0001dc80,121984,36,1,2,3,MAIN.EXE
FUN_0001cbb8,117688,32,2,1,3,MAIN.EXE
FUN_00021424,136228,28,3,0,3,MAIN.EXE
FUN_0001ab7c,109436,24,1,2,3,MAIN.EXE
FUN_0002158c,136588,24,2,1,3,MAIN.EXE
FUN_00032d54,208212,20,3,0,3,MAIN.EXE
FUN_0001a100,106752,16,3,0,3,MAIN.EXE
FUN_0001dd68,122216,16,3,0,3,MAIN.EXE
FUN_00030558,197976,16,3,0,3,MAIN.EXE
thunk_FUN_00042004,229684,12,2,1,3,MAIN.EXE
FUN_000184b8,99512,8,3,0,3,MAIN.EXE
FUN_00030840,198720,8,2,1,3,MAIN.EXE
FUN_0001f340,127808,4,3,0,3,MAIN.EXE
FUN_00029a4c,170572,4,2,1,3,MAIN.EXE
FUN_0002aa30,174640,4,3,0,3,MAIN.EXE
FUN_0002d220,184864,4,3,0,3,MAIN.EXE
FUN_0002f22c,193068,4,2,1,3,MAIN.EXE
FUN_000354b0,218288,4,3,0,3,MAIN.EXE
FUN_00035800,219136,4,3,0,3,MAIN.EXE
FUN_0002705c,159836,1,3,0,3,MAIN.EXE
FUN_0003591c,219420,1,3,0,3,MAIN.EXE
FUN_00039c38,236600,1,3,0,3,MAIN.EXE
FUN_00011cdc,72924,984,0,2,2,MAIN.EXE
FUN_000021d4,8660,608,0,2,2,MAIN.EXE
FUN_00001954,6484,572,0,2,2,MAIN.EXE
FUN_0001b72c,112428,568,0,2,2,MAIN.EXE
FUN_0000d5c8,54728,520,0,2,2,MAIN.EXE
FUN_0001b554,111956,472,0,2,2,MAIN.EXE
FUN_0000eb10,60176,384,0,2,2,MAIN.EXE
FUN_00003b7c,15228,372,0,2,2,MAIN.EXE
FUN_0001ad84,109956,364,0,2,2,MAIN.EXE
FUN_0002105c,135260,328,0,2,2,MAIN.EXE
FUN_0001abfc,109564,288,0,2,2,MAIN.EXE
FUN_0000e5f0,58864,280,0,2,2,MAIN.EXE
FUN_0001b264,111204,256,1,1,2,MAIN.EXE
FUN_000331f4,209396,252,2,0,2,MAIN.EXE
FUN_00010700,67328,236,0,2,2,MAIN.EXE
FUN_00023c90,146576,228,1,1,2,MAIN.EXE
FUN_00001644,5700,224,0,2,2,MAIN.EXE
FUN_000155a0,87456,212,0,2,2,MAIN.EXE
FUN_0001d404,119812,212,0,2,2,MAIN.EXE
FUN_0000a070,41072,204,0,2,2,MAIN.EXE
FUN_000138d0,80080,204,0,2,2,MAIN.EXE
FUN_00032278,205432,200,2,0,2,MAIN.EXE
FUN_00002e74,11892,192,0,2,2,MAIN.EXE
FUN_0001a674,108148,192,2,0,2,MAIN.EXE
FUN_000126dc,75484,188,0,2,2,MAIN.EXE
FUN_00009cd4,40148,184,0,2,2,MAIN.EXE
FUN_00029414,168980,180,2,0,2,MAIN.EXE
FUN_00002584,9604,168,0,2,2,MAIN.EXE
FUN_00014910,84240,164,0,2,2,MAIN.EXE
FUN_00006368,25448,160,0,2,2,MAIN.EXE
FUN_0000f350,62288,156,0,2,2,MAIN.EXE
FUN_00009b18,39704,152,0,2,2,MAIN.EXE
FUN_0001f734,128820,152,0,2,2,MAIN.EXE
FUN_000157ac,87980,148,0,2,2,MAIN.EXE
FUN_00015840,88128,148,0,2,2,MAIN.EXE
FUN_0000a464,42084,140,0,2,2,MAIN.EXE
FUN_0000ac5c,44124,132,0,2,2,MAIN.EXE
FUN_00012a18,76312,132,0,2,2,MAIN.EXE
FUN_0000d3bc,54204,124,0,2,2,MAIN.EXE
FUN_000159a4,88484,124,0,2,2,MAIN.EXE
FUN_0001ef54,126804,124,0,2,2,MAIN.EXE
FUN_00006408,25608,120,0,2,2,MAIN.EXE
FUN_000212a0,135840,120,1,1,2,MAIN.EXE
FUN_00024604,148996,116,2,0,2,MAIN.EXE
FUN_0001ecc0,126144,112,1,1,2,MAIN.EXE
FUN_00021ef4,138996,112,1,1,2,MAIN.EXE
FUN_0000d154,53588,108,0,2,2,MAIN.EXE
FUN_0001ee5c,126556,108,0,2,2,MAIN.EXE
FUN_000120bc,73916,104,0,2,2,MAIN.EXE
FUN_0001a348,107336,104,1,1,2,MAIN.EXE
FUN_0002245c,140380,104,1,1,2,MAIN.EXE
FUN_00000ad4,2772,100,0,2,2,MAIN.EXE
FUN_00004f98,20376,100,0,2,2,MAIN.EXE
FUN_00003824,14372,96,0,2,2,MAIN.EXE
FUN_00008c84,35972,96,0,2,2,MAIN.EXE
FUN_00008e54,36436,96,0,2,2,MAIN.EXE
FUN_00009d8c,40332,96,0,2,2,MAIN.EXE
FUN_0001eb14,125716,96,2,0,2,MAIN.EXE
FUN_00014880,84096,92,0,2,2,MAIN.EXE
FUN_0000364c,13900,88,0,2,2,MAIN.EXE
FUN_00006658,26200,88,0,2,2,MAIN.EXE
FUN_00023bd8,146392,84,1,1,2,MAIN.EXE
FUN_0001ca54,117332,80,1,1,2,MAIN.EXE
FUN_0002d040,184384,80,2,0,2,MAIN.EXE
FUN_00006904,26884,76,0,2,2,MAIN.EXE
FUN_0000bd88,48520,76,0,2,2,MAIN.EXE
FUN_00017b1c,97052,76,0,2,2,MAIN.EXE
FUN_0001a178,106872,76,0,2,2,MAIN.EXE
FUN_00018338,99128,72,1,1,2,MAIN.EXE
FUN_00023af4,146164,68,1,1,2,MAIN.EXE
FUN_00025c18,154648,68,2,0,2,MAIN.EXE
FUN_00025f10,155408,68,2,0,2,MAIN.EXE
FUN_000264b8,156856,68,2,0,2,MAIN.EXE
FUN_0000c9f0,51696,64,0,2,2,MAIN.EXE
FUN_0000a5ec,42476,60,0,2,2,MAIN.EXE
FUN_0000ca30,51760,60,0,2,2,MAIN.EXE
FUN_0000cc00,52224,60,0,2,2,MAIN.EXE
FUN_00015a40,88640,60,0,2,2,MAIN.EXE
FUN_00015a7c,88700,60,0,2,2,MAIN.EXE
FUN_000160ac,90284,60,0,2,2,MAIN.EXE
FUN_000189d0,100816,60,1,1,2,MAIN.EXE
FUN_000233a0,144288,60,1,1,2,MAIN.EXE
FUN_00018d58,101720,56,0,2,2,MAIN.EXE
FUN_00020654,132692,56,1,1,2,MAIN.EXE
FUN_00020f08,134920,56,1,1,2,MAIN.EXE
FUN_00015970,88432,52,0,2,2,MAIN.EXE
FUN_0001a7d0,108496,52,0,2,2,MAIN.EXE
FUN_000207bc,133052,52,1,1,2,MAIN.EXE
FUN_0001eb74,125812,48,1,1,2,MAIN.EXE
FUN_0002f368,193384,48,2,0,2,MAIN.EXE
FUN_00019688,104072,44,1,1,2,MAIN.EXE
FUN_00021cf0,138480,44,2,0,2,MAIN.EXE
FUN_0002cfac,184236,44,2,0,2,MAIN.EXE
FUN_0001f000,126976,40,1,1,2,MAIN.EXE
FUN_000219ac,137644,40,1,1,2,MAIN.EXE
FUN_00018c60,101472,36,2,0,2,MAIN.EXE
FUN_00021478,136312,36,1,1,2,MAIN.EXE
FUN_00026310,156432,36,2,0,2,MAIN.EXE
FUN_00018c40,101440,32,2,0,2,MAIN.EXE
FUN_0001c8cc,116940,32,1,1,2,MAIN.EXE
FUN_0001cbd8,117720,32,2,0,2,MAIN.EXE
FUN_000199d4,104916,28,1,1,2,MAIN.EXE
FUN_0001ec74,126068,28,1,1,2,MAIN.EXE
FUN_0002ad90,175504,28,2,0,2,MAIN.EXE
FUN_0002db3c,187196,28,2,0,2,MAIN.EXE
FUN_0003186c,202860,28,2,0,2,MAIN.EXE
FUN_0001c95c,117084,24,1,1,2,MAIN.EXE
FUN_0001a28c,107148,20,1,1,2,MAIN.EXE
FUN_0001dad0,121552,20,1,1,2,MAIN.EXE
FUN_00024858,149592,20,2,0,2,MAIN.EXE
FUN_00031978,203128,20,2,0,2,MAIN.EXE
FUN_00018f7c,102268,16,1,1,2,MAIN.EXE
FUN_0001a038,106552,16,1,1,2,MAIN.EXE
FUN_0001c984,117124,16,1,1,2,MAIN.EXE
FUN_0001c9a4,117156,16,1,1,2,MAIN.EXE
FUN_0001ca14,117268,16,2,0,2,MAIN.EXE
FUN_0001ca34,117300,16,2,0,2,MAIN.EXE
FUN_0001cbf8,117752,16,2,0,2,MAIN.EXE
FUN_00024590,148880,16,2,0,2,MAIN.EXE
FUN_0002d9fc,186876,16,2,0,2,MAIN.EXE
FUN_0001a12c,106796,12,2,0,2,MAIN.EXE
FUN_000216f8,136952,12,1,1,2,MAIN.EXE
FUN_00030cc8,199880,12,2,0,2,MAIN.EXE
FUN_00030d08,199944,12,1,1,2,MAIN.EXE
FUN_00031b20,203552,12,2,0,2,MAIN.EXE
FUN_00031c7c,203900,12,2,0,2,MAIN.EXE
thunk_FUN_00033fd0,116632,8,2,0,2,MAIN.EXE
FUN_0001cc18,117784,8,2,0,2,MAIN.EXE
FUN_000213b0,136112,8,1,1,2,MAIN.EXE
FUN_00029a1c,170524,8,1,1,2,MAIN.EXE
FUN_0002d0d4,184532,8,2,0,2,MAIN.EXE
FUN_0002ef90,192400,8,1,1,2,MAIN.EXE
FUN_000307a4,198564,8,2,0,2,MAIN.EXE
FUN_00030980,199040,8,1,1,2,MAIN.EXE
FUN_0001c9e4,117220,4,2,0,2,MAIN.EXE
FUN_000242f8,148216,4,2,0,2,MAIN.EXE
FUN_00029c5c,171100,4,1,1,2,MAIN.EXE
FUN_0002bb80,179072,4,2,0,2,MAIN.EXE
thunk_FUN_00040028,198964,4,2,0,2,MAIN.EXE
thunk_FUN_00040020,200212,4,2,0,2,MAIN.EXE
FUN_00034460,214112,4,2,0,2,MAIN.EXE
FUN_000354f0,218352,4,2,0,2,MAIN.EXE
FUN_00035858,219224,4,2,0,2,MAIN.EXE
FUN_000358f0,219376,4,2,0,2,MAIN.EXE
FUN_000366c8,222920,4,2,0,2,MAIN.EXE
FUN_0003aa90,240272,4,2,0,2,MAIN.EXE
FUN_00040020,262176,4,2,0,2,MAIN.EXE
FUN_0004002c,262188,4,2,0,2,MAIN.EXE
FUN_00024400,148480,1,2,0,2,MAIN.EXE
FUN_00024954,149844,1,2,0,2,MAIN.EXE
FUN_00024c38,150584,1,2,0,2,MAIN.EXE
FUN_00024d34,150836,1,2,0,2,MAIN.EXE
FUN_00029f98,171928,1,2,0,2,MAIN.EXE
FUN_0002a29c,172700,1,2,0,2,MAIN.EXE
FUN_0002a2e0,172768,1,2,0,2,MAIN.EXE
FUN_0002a418,173080,1,2,0,2,MAIN.EXE
FUN_0002a4b0,173232,1,2,0,2,MAIN.EXE
FUN_0002c780,182144,1,2,0,2,MAIN.EXE
FUN_0002ce90,183952,1,2,0,2,MAIN.EXE
FUN_0002d0ec,184556,1,2,0,2,MAIN.EXE
FUN_0002d2b8,185016,1,2,0,2,MAIN.EXE
FUN_0002fec0,196288,1,2,0,2,MAIN.EXE
FUN_00030740,198464,1,2,0,2,MAIN.EXE
FUN_00030de8,200168,1,2,0,2,MAIN.EXE
FUN_00031cd0,203984,1,2,0,2,MAIN.EXE
FUN_00032a20,207392,1,2,0,2,MAIN.EXE
FUN_000336e4,210660,1,2,0,2,MAIN.EXE
FUN_00033724,210724,1,2,0,2,MAIN.EXE
FUN_000356b4,218804,1,2,0,2,MAIN.EXE
FUN_00035884,219268,1,2,0,2,MAIN.EXE
FUN_00035914,219412,1,2,0,2,MAIN.EXE
FUN_00035984,219524,1,2,0,2,MAIN.EXE
FUN_00035ad4,219860,1,2,0,2,MAIN.EXE
FUN_00037ec8,229064,1,2,0,2,MAIN.EXE
FUN_00038180,229760,1,2,0,2,MAIN.EXE
FUN_00038414,230420,1,2,0,2,MAIN.EXE
FUN_00038b34,232244,1,2,0,2,MAIN.EXE
FUN_0003a9ec,240108,1,2,0,2,MAIN.EXE
FUN_0003aad4,240340,1,2,0,2,MAIN.EXE
FUN_00010944,67908,1408,0,1,1,MAIN.EXE
FUN_00032004,204804,628,1,0,1,MAIN.EXE
FUN_0003b9a4,244132,448,1,0,1,MAIN.EXE
FUN_00000b38,2872,384,0,1,1,MAIN.EXE
FUN_000066b0,26288,384,0,1,1,MAIN.EXE
FUN_00030374,197492,368,1,0,1,MAIN.EXE
FUN_00014520,83232,316,0,1,1,MAIN.EXE
FUN_00016384,91012,316,0,1,1,MAIN.EXE
FUN_000164c0,91328,308,0,1,1,MAIN.EXE
FUN_00021334,135988,292,0,1,1,MAIN.EXE
FUN_0001afb4,110516,284,1,0,1,MAIN.EXE
FUN_0002e8e4,190692,280,1,0,1,MAIN.EXE
FUN_00020820,133152,276,0,1,1,MAIN.EXE
FUN_0000ecb8,60600,260,0,1,1,MAIN.EXE
FUN_0002b1a0,176544,260,1,0,1,MAIN.EXE
FUN_000009d8,2520,252,0,1,1,MAIN.EXE
FUN_000206c8,132808,244,0,1,1,MAIN.EXE
FUN_0001d504,120068,236,0,1,1,MAIN.EXE
FUN_0000e418,58392,232,0,1,1,MAIN.EXE
FUN_0001e674,124532,220,1,0,1,MAIN.EXE
FUN_00016ea4,93860,216,0,1,1,MAIN.EXE
FUN_00007fcc,32716,212,0,1,1,MAIN.EXE
FUN_0001c178,115064,212,0,1,1,MAIN.EXE
FUN_00020980,133504,212,0,1,1,MAIN.EXE
FUN_00029344,168772,208,1,0,1,MAIN.EXE
FUN_0002f548,193864,204,1,0,1,MAIN.EXE
FUN_0003b468,242792,204,1,0,1,MAIN.EXE
FUN_0000cc3c,52284,200,0,1,1,MAIN.EXE
FUN_0000e710,59152,192,0,1,1,MAIN.EXE
FUN_0001c48c,115852,192,0,1,1,MAIN.EXE
FUN_0002fc24,195620,192,1,0,1,MAIN.EXE
FUN_00002ca0,11424,184,0,1,1,MAIN.EXE
FUN_00000fc4,4036,180,0,1,1,MAIN.EXE
FUN_0002abec,175084,176,1,0,1,MAIN.EXE
FUN_0000edc8,60872,172,0,1,1,MAIN.EXE
FUN_0001cc74,117876,168,0,1,1,MAIN.EXE
FUN_0000ad78,44408,164,0,1,1,MAIN.EXE
FUN_00018380,99200,164,0,1,1,MAIN.EXE
FUN_000231ec,143852,164,0,1,1,MAIN.EXE
FUN_0002fb80,195456,164,1,0,1,MAIN.EXE
FUN_0001f344,127812,156,0,1,1,MAIN.EXE
FUN_00002ab0,10928,152,0,1,1,MAIN.EXE
FUN_0000e078,57464,152,0,1,1,MAIN.EXE
FUN_0001942c,103468,152,1,0,1,MAIN.EXE
FUN_00019724,104228,152,1,0,1,MAIN.EXE
FUN_0000d534,54580,148,0,1,1,MAIN.EXE
FUN_00002bb0,11184,144,0,1,1,MAIN.EXE
FUN_0000ef68,61288,144,0,1,1,MAIN.EXE
FUN_0000f060,61536,144,0,1,1,MAIN.EXE
FUN_00015690,87696,144,0,1,1,MAIN.EXE
FUN_00019614,103956,144,0,1,1,MAIN.EXE
FUN_0001a3b0,107440,144,1,0,1,MAIN.EXE
FUN_0001b964,112996,144,0,1,1,MAIN.EXE
FUN_00015720,87840,140,0,1,1,MAIN.EXE
FUN_0001c54c,116044,140,0,1,1,MAIN.EXE
FUN_0001eec8,126664,140,0,1,1,MAIN.EXE
FUN_0000a1ac,41388,136,0,1,1,MAIN.EXE
FUN_00019388,103304,132,0,1,1,MAIN.EXE
FUN_0001a1c4,106948,132,0,1,1,MAIN.EXE
FUN_000158ec,88300,124,0,1,1,MAIN.EXE
FUN_000234b8,144568,124,0,1,1,MAIN.EXE
FUN_00018c84,101508,116,0,1,1,MAIN.EXE
FUN_00020e04,134660,112,0,1,1,MAIN.EXE
FUN_0000c144,49476,108,0,1,1,MAIN.EXE
FUN_0002e9fc,190972,108,1,0,1,MAIN.EXE
FUN_00039078,233592,108,1,0,1,MAIN.EXE
FUN_0000eff8,61432,104,0,1,1,MAIN.EXE
FUN_00029228,168488,100,1,0,1,MAIN.EXE
FUN_00002c40,11328,96,0,1,1,MAIN.EXE
FUN_000191b8,102840,96,0,1,1,MAIN.EXE
FUN_0001a614,108052,96,0,1,1,MAIN.EXE
FUN_0001be70,114288,96,0,1,1,MAIN.EXE
FUN_000249c0,149952,96,1,0,1,MAIN.EXE
FUN_00014820,84000,92,0,1,1,MAIN.EXE
FUN_0001e000,122880,88,0,1,1,MAIN.EXE
FUN_00024fd8,151512,88,1,0,1,MAIN.EXE
FUN_000196d0,104144,84,1,0,1,MAIN.EXE
FUN_00026228,156200,84,1,0,1,MAIN.EXE
FUN_0000cdb4,52660,80,0,1,1,MAIN.EXE
FUN_0000e7d0,59344,80,0,1,1,MAIN.EXE
FUN_0002cf20,184096,80,1,0,1,MAIN.EXE
FUN_0000ace0,44256,76,0,1,1,MAIN.EXE
FUN_0000ef18,61208,76,0,1,1,MAIN.EXE
FUN_000224e0,140512,76,1,0,1,MAIN.EXE
FUN_00023588,144776,76,1,0,1,MAIN.EXE
FUN_000080a0,32928,72,0,1,1,MAIN.EXE
FUN_0000d1c0,53696,72,0,1,1,MAIN.EXE
FUN_0000ea9c,60060,72,0,1,1,MAIN.EXE
FUN_00018f40,102208,72,0,1,1,MAIN.EXE
FUN_0001c36c,115564,72,0,1,1,MAIN.EXE
FUN_0001cd54,118100,72,0,1,1,MAIN.EXE
FUN_00009968,39272,68,0,1,1,MAIN.EXE
FUN_0001d850,120912,68,1,0,1,MAIN.EXE
FUN_00023544,144708,68,1,0,1,MAIN.EXE
FUN_00023b38,146232,68,1,0,1,MAIN.EXE
FUN_00023b94,146324,68,1,0,1,MAIN.EXE
FUN_00025318,152344,68,1,0,1,MAIN.EXE
FUN_000255d0,153040,68,1,0,1,MAIN.EXE
FUN_0002562c,153132,68,1,0,1,MAIN.EXE
FUN_00025680,153216,68,1,0,1,MAIN.EXE
FUN_000256c8,153288,68,1,0,1,MAIN.EXE
FUN_00025778,153464,68,1,0,1,MAIN.EXE
FUN_00025878,153720,68,1,0,1,MAIN.EXE
FUN_00025c84,154756,68,1,0,1,MAIN.EXE
FUN_00025fd0,155600,68,1,0,1,MAIN.EXE
FUN_00026020,155680,68,1,0,1,MAIN.EXE
FUN_000260e0,155872,68,1,0,1,MAIN.EXE
FUN_00026190,156048,68,1,0,1,MAIN.EXE
FUN_000263fc,156668,68,1,0,1,MAIN.EXE
FUN_0002b0d0,176336,68,1,0,1,MAIN.EXE
FUN_00042004,270340,68,1,0,1,MAIN.EXE
FUN_0001c788,116616,64,1,0,1,MAIN.EXE
FUN_0001c90c,117004,64,1,0,1,MAIN.EXE
FUN_0001ed30,126256,64,1,0,1,MAIN.EXE
FUN_00020484,132228,64,1,0,1,MAIN.EXE
FUN_00025d08,154888,64,1,0,1,MAIN.EXE
FUN_00025d78,155000,64,1,0,1,MAIN.EXE
FUN_00009e44,40516,60,0,1,1,MAIN.EXE
FUN_0000bba0,48032,60,0,1,1,MAIN.EXE
FUN_0000f310,62224,60,0,1,1,MAIN.EXE
FUN_0001dae8,121576,60,1,0,1,MAIN.EXE
FUN_0001db24,121636,60,0,1,1,MAIN.EXE
FUN_0001db60,121696,60,0,1,1,MAIN.EXE
FUN_0001f1a0,127392,60,1,0,1,MAIN.EXE
FUN_00021644,136772,60,1,0,1,MAIN.EXE
FUN_00022438,140344,60,0,1,1,MAIN.EXE
FUN_00031f94,204692,60,1,0,1,MAIN.EXE
FUN_0000e5b8,58808,56,0,1,1,MAIN.EXE
FUN_00018784,100228,56,1,0,1,MAIN.EXE
FUN_0001cd1c,118044,56,0,1,1,MAIN.EXE
FUN_00025db8,155064,56,1,0,1,MAIN.EXE
FUN_0002c580,181632,56,1,0,1,MAIN.EXE
FUN_0002d65c,185948,56,1,0,1,MAIN.EXE
FUN_000326f0,206576,56,1,0,1,MAIN.EXE
FUN_00001f24,7972,52,0,1,1,MAIN.EXE
FUN_000026c0,9920,52,0,1,1,MAIN.EXE
FUN_00008fbc,36796,52,0,1,1,MAIN.EXE
FUN_0000bbdc,48092,52,0,1,1,MAIN.EXE
FUN_000107ec,67564,52,0,1,1,MAIN.EXE
FUN_00012128,74024,52,0,1,1,MAIN.EXE
FUN_0002eb64,191332,52,1,0,1,MAIN.EXE
FUN_00031fd0,204752,52,1,0,1,MAIN.EXE
FUN_000084f8,34040,48,0,1,1,MAIN.EXE
FUN_0001a528,107816,48,0,1,1,MAIN.EXE
FUN_0001de28,122408,48,1,0,1,MAIN.EXE
FUN_0001eba4,125860,48,1,0,1,MAIN.EXE
FUN_0001ebd4,125908,48,1,0,1,MAIN.EXE
FUN_000207f0,133104,48,1,0,1,MAIN.EXE
FUN_00021974,137588,48,1,0,1,MAIN.EXE
FUN_00025918,153880,48,1,0,1,MAIN.EXE
FUN_0002b050,176208,48,1,0,1,MAIN.EXE
FUN_0002d62c,185900,48,1,0,1,MAIN.EXE
FUN_0000e118,57624,44,0,1,1,MAIN.EXE
FUN_00015e2c,89644,44,0,1,1,MAIN.EXE
FUN_00024748,149320,44,1,0,1,MAIN.EXE
FUN_0002d8ac,186540,44,1,0,1,MAIN.EXE
FUN_000028d8,10456,40,0,1,1,MAIN.EXE
FUN_00007dc0,32192,40,0,1,1,MAIN.EXE
FUN_00007de8,32232,40,0,1,1,MAIN.EXE
FUN_0000ec90,60560,40,0,1,1,MAIN.EXE
FUN_0001221c,74268,40,0,1,1,MAIN.EXE
FUN_000160e8,90344,40,0,1,1,MAIN.EXE
FUN_00016110,90384,40,0,1,1,MAIN.EXE
FUN_00016138,90424,40,0,1,1,MAIN.EXE
FUN_00026490,156816,40,1,0,1,MAIN.EXE
FUN_0002ad68,175464,40,1,0,1,MAIN.EXE
FUN_0002fb58,195416,40,1,0,1,MAIN.EXE
FUN_00001f00,7936,36,0,1,1,MAIN.EXE
FUN_00012c80,76928,36,0,1,1,MAIN.EXE
FUN_00013850,79952,36,0,1,1,MAIN.EXE
FUN_00014350,82768,36,0,1,1,MAIN.EXE
FUN_00015ab8,88760,36,0,1,1,MAIN.EXE
FUN_00015e5c,89692,36,0,1,1,MAIN.EXE
FUN_00016780,92032,36,0,1,1,MAIN.EXE
FUN_000195f0,103920,36,1,0,1,MAIN.EXE
FUN_0001dcb0,122032,36,0,1,1,MAIN.EXE
FUN_00023c3c,146492,36,1,0,1,MAIN.EXE
FUN_0002b2f8,176888,36,1,0,1,MAIN.EXE
FUN_0000eaf0,60144,32,0,1,1,MAIN.EXE
FUN_00012e10,77328,32,0,1,1,MAIN.EXE
FUN_00012e30,77360,32,0,1,1,MAIN.EXE
FUN_00015a20,88608,32,0,1,1,MAIN.EXE
FUN_00016294,90772,32,0,1,1,MAIN.EXE
FUN_0001631c,90908,32,0,1,1,MAIN.EXE
FUN_0001633c,90940,32,0,1,1,MAIN.EXE
FUN_00016740,91968,32,0,1,1,MAIN.EXE
FUN_00016760,92000,32,0,1,1,MAIN.EXE
FUN_000167a4,92068,32,0,1,1,MAIN.EXE
FUN_0001809c,98460,32,0,1,1,MAIN.EXE
FUN_00019108,102664,32,0,1,1,MAIN.EXE
FUN_0001c8ec,116972,32,1,0,1,MAIN.EXE
FUN_0001ec04,125956,32,1,0,1,MAIN.EXE
FUN_0001ec24,125988,32,1,0,1,MAIN.EXE
FUN_0001ec44,126020,32,1,0,1,MAIN.EXE
FUN_0002193c,137532,32,1,0,1,MAIN.EXE
FUN_000241a4,147876,32,0,1,1,MAIN.EXE
FUN_000262f0,156400,32,1,0,1,MAIN.EXE
FUN_0002c110,180496,32,1,0,1,MAIN.EXE
FUN_0002c198,180632,32,1,0,1,MAIN.EXE
FUN_0003192c,203052,32,1,0,1,MAIN.EXE
FUN_00021318,135960,28,1,0,1,MAIN.EXE
FUN_0002209c,139420,28,1,0,1,MAIN.EXE
FUN_00024dc8,150984,28,1,0,1,MAIN.EXE
FUN_000250b8,151736,28,1,0,1,MAIN.EXE
FUN_000262d4,156372,28,1,0,1,MAIN.EXE
FUN_0001e16c,123244,24,1,0,1,MAIN.EXE
FUN_000215ec,136684,24,1,0,1,MAIN.EXE
FUN_00025300,152320,24,1,0,1,MAIN.EXE
FUN_00025ef8,155384,24,1,0,1,MAIN.EXE
FUN_0002b180,176512,24,1,0,1,MAIN.EXE
FUN_0002c1e8,180712,24,1,0,1,MAIN.EXE
FUN_0002df10,188176,24,1,0,1,MAIN.EXE
FUN_00032f14,208660,24,1,0,1,MAIN.EXE
FUN_0001a0ec,106732,20,0,1,1,MAIN.EXE
FUN_0001e0dc,123100,20,1,0,1,MAIN.EXE
FUN_00021680,136832,20,1,0,1,MAIN.EXE
FUN_00025948,153928,20,1,0,1,MAIN.EXE
FUN_0002b080,176256,20,1,0,1,MAIN.EXE
FUN_0002dfa4,188324,20,1,0,1,MAIN.EXE
FUN_0002fdb4,196020,20,1,0,1,MAIN.EXE
FUN_00038254,229972,20,1,0,1,MAIN.EXE
FUN_0001a028,106536,16,1,0,1,MAIN.EXE
FUN_0001c7ec,116716,16,1,0,1,MAIN.EXE
FUN_0001c9b4,117172,16,1,0,1,MAIN.EXE
FUN_0001c9c4,117188,16,1,0,1,MAIN.EXE
FUN_0001c9d4,117204,16,1,0,1,MAIN.EXE
FUN_0001ca24,117284,16,1,0,1,MAIN.EXE
FUN_0001cb78,117624,16,1,0,1,MAIN.EXE
FUN_0001cb88,117640,16,1,0,1,MAIN.EXE
FUN_0001d5f0,120304,16,1,0,1,MAIN.EXE
FUN_0001e104,123140,16,1,0,1,MAIN.EXE
FUN_0001ec64,126052,16,1,0,1,MAIN.EXE
FUN_00021850,137296,16,1,0,1,MAIN.EXE
FUN_00021a34,137780,16,1,0,1,MAIN.EXE
FUN_000234a8,144552,16,1,0,1,MAIN.EXE
FUN_00023534,144692,16,1,0,1,MAIN.EXE
FUN_00023ae4,146148,16,1,0,1,MAIN.EXE
FUN_00023b84,146308,16,1,0,1,MAIN.EXE
FUN_00023c2c,146476,16,1,0,1,MAIN.EXE
FUN_00023c70,146544,16,1,0,1,MAIN.EXE
FUN_00023c80,146560,16,1,0,1,MAIN.EXE
FUN_00024504,148740,16,1,0,1,MAIN.EXE
FUN_00027fec,163820,16,1,0,1,MAIN.EXE
FUN_0002ab14,174868,16,1,0,1,MAIN.EXE
FUN_0002b4bc,177340,16,1,0,1,MAIN.EXE
FUN_0002d030,184368,16,1,0,1,MAIN.EXE
FUN_0002d9ec,186860,16,1,0,1,MAIN.EXE
FUN_0002da84,187012,16,1,0,1,MAIN.EXE
FUN_0002eb34,191284,16,1,0,1,MAIN.EXE
FUN_0002f538,193848,16,1,0,1,MAIN.EXE
FUN_000318ec,202988,16,1,0,1,MAIN.EXE
FUN_00031938,203064,16,1,0,1,MAIN.EXE
FUN_000327a8,206760,16,1,0,1,MAIN.EXE
FUN_00019c34,105524,12,1,0,1,MAIN.EXE
FUN_0001caf0,117488,12,1,0,1,MAIN.EXE
FUN_000220c0,139456,12,1,0,1,MAIN.EXE
FUN_00025cfc,154876,12,1,0,1,MAIN.EXE
FUN_00025df0,155120,12,1,0,1,MAIN.EXE
FUN_0002b644,177732,12,1,0,1,MAIN.EXE
FUN_0002b680,177792,12,1,0,1,MAIN.EXE
FUN_0002c020,180256,12,1,0,1,MAIN.EXE
FUN_0002c080,180352,12,1,0,1,MAIN.EXE
FUN_0002d680,185984,12,1,0,1,MAIN.EXE
FUN_0002da0c,186892,12,1,0,1,MAIN.EXE
FUN_0002f31c,193308,12,1,0,1,MAIN.EXE
FUN_00030b88,199560,12,1,0,1,MAIN.EXE
FUN_00030c18,199704,12,1,0,1,MAIN.EXE
FUN_00031368,201576,12,1,0,1,MAIN.EXE
FUN_0001912c,102700,8,1,0,1,MAIN.EXE
FUN_0001c94c,117068,8,1,0,1,MAIN.EXE
FUN_0001c994,117140,8,1,0,1,MAIN.EXE
FUN_0001cb28,117544,8,1,0,1,MAIN.EXE
thunk_FUN_00034460,117832,8,1,0,1,MAIN.EXE
FUN_0001e514,124180,8,1,0,1,MAIN.EXE
FUN_00021168,135528,8,1,0,1,MAIN.EXE
FUN_00021708,136968,8,1,0,1,MAIN.EXE
FUN_00021870,137328,8,1,0,1,MAIN.EXE
FUN_0002437c,148348,8,1,0,1,MAIN.EXE
FUN_00024b88,150408,8,1,0,1,MAIN.EXE
FUN_000252ac,152236,8,1,0,1,MAIN.EXE
FUN_0002f7b0,194480,8,1,0,1,MAIN.EXE
FUN_00030728,198440,8,1,0,1,MAIN.EXE
FUN_00030b6c,199532,8,1,0,1,MAIN.EXE
thunk_EXT_FUN_0ffc0014,200428,8,1,0,1,MAIN.EXE
FUN_000317d0,202704,8,1,0,1,MAIN.EXE
FUN_00040018,262168,8,1,0,1,MAIN.EXE
FUN_00024350,148304,4,1,0,1,MAIN.EXE
FUN_00024b78,150392,4,1,0,1,MAIN.EXE
thunk_EXT_FUN_09d1c1d4,151732,4,1,0,1,MAIN.EXE
FUN_000250d4,151764,4,1,0,1,MAIN.EXE
FUN_00025d48,154952,4,1,0,1,MAIN.EXE
FUN_000265c8,157128,4,1,0,1,MAIN.EXE
FUN_000274ec,161004,4,1,0,1,MAIN.EXE
FUN_00027d4c,163148,4,1,0,1,MAIN.EXE
FUN_00027fb0,163760,4,1,0,1,MAIN.EXE
FUN_00028fd0,167888,4,1,0,1,MAIN.EXE
FUN_000290fc,168188,4,1,0,1,MAIN.EXE
FUN_00029a00,170496,4,1,0,1,MAIN.EXE
FUN_0002aac0,174784,4,1,0,1,MAIN.EXE
FUN_0002bb50,179024,4,1,0,1,MAIN.EXE
FUN_0002bcf0,179440,4,1,0,1,MAIN.EXE
FUN_0002bd20,179488,4,1,0,1,MAIN.EXE
FUN_0002be60,179808,4,1,0,1,MAIN.EXE
thunk_EXT_FUN_0ff8002c,180428,4,1,0,1,MAIN.EXE
FUN_0002c920,182560,4,1,0,1,MAIN.EXE
FUN_0002ca00,182784,4,1,0,1,MAIN.EXE
FUN_0002cc00,183296,4,1,0,1,MAIN.EXE
FUN_0002ce80,183936,4,1,0,1,MAIN.EXE
FUN_0002d0c4,184516,4,1,0,1,MAIN.EXE
FUN_0002d200,184832,4,1,0,1,MAIN.EXE
FUN_0002da1c,186908,4,1,0,1,MAIN.EXE
FUN_0002da94,187028,4,1,0,1,MAIN.EXE
FUN_0002db1c,187164,4,1,0,1,MAIN.EXE
FUN_0002dcc0,187584,4,1,0,1,MAIN.EXE
FUN_0002e8b4,190644,4,1,0,1,MAIN.EXE
FUN_0002ec94,191636,4,1,0,1,MAIN.EXE
FUN_0002ff34,196404,4,1,0,1,MAIN.EXE
FUN_000302ac,197292,4,1,0,1,MAIN.EXE
FUN_00030a64,199268,4,1,0,1,MAIN.EXE
thunk_EXT_FUN_0ffc0030,200636,4,1,0,1,MAIN.EXE
FUN_00031734,202548,4,1,0,1,MAIN.EXE
FUN_00031e14,204308,4,1,0,1,MAIN.EXE
FUN_000329dc,207324,4,1,0,1,MAIN.EXE
FUN_00032c2c,207916,4,1,0,1,MAIN.EXE
FUN_000336bc,210620,4,1,0,1,MAIN.EXE
FUN_000338e0,211168,4,1,0,1,MAIN.EXE
FUN_00033930,211248,4,1,0,1,MAIN.EXE
FUN_00033940,211264,4,1,0,1,MAIN.EXE
FUN_00033978,211320,4,1,0,1,MAIN.EXE
FUN_00033a38,211512,4,1,0,1,MAIN.EXE
FUN_00034130,213296,4,1,0,1,MAIN.EXE
FUN_000341e0,213472,4,1,0,1,MAIN.EXE
FUN_000341e8,213480,4,1,0,1,MAIN.EXE
FUN_00034298,213656,4,1,0,1,MAIN.EXE
FUN_000342a8,213672,4,1,0,1,MAIN.EXE
FUN_00034508,214280,4,1,0,1,MAIN.EXE
FUN_00034680,214656,4,1,0,1,MAIN.EXE
FUN_00034700,214784,4,1,0,1,MAIN.EXE
FUN_000348a0,215200,4,1,0,1,MAIN.EXE
FUN_00034a38,215608,4,1,0,1,MAIN.EXE
FUN_00034cc8,216264,4,1,0,1,MAIN.EXE
FUN_00034f08,216840,4,1,0,1,MAIN.EXE
FUN_00034f40,216896,4,1,0,1,MAIN.EXE
FUN_00034fb8,217016,4,1,0,1,MAIN.EXE
FUN_00035190,217488,4,1,0,1,MAIN.EXE
FUN_000351c8,217544,4,1,0,1,MAIN.EXE
FUN_00035a68,219752,4,1,0,1,MAIN.EXE
FUN_00035f50,221008,4,1,0,1,MAIN.EXE
FUN_00036620,222752,4,1,0,1,MAIN.EXE
FUN_00036da8,224680,4,1,0,1,MAIN.EXE
FUN_00036ea0,224928,4,1,0,1,MAIN.EXE
FUN_00037680,226944,4,1,0,1,MAIN.EXE
FUN_00037bf0,228336,4,1,0,1,MAIN.EXE
FUN_000397f4,235508,4,1,0,1,MAIN.EXE
FUN_00039a34,236084,4,1,0,1,MAIN.EXE
FUN_0003a8a8,239784,4,1,0,1,MAIN.EXE
FUN_0003acb8,240824,4,1,0,1,MAIN.EXE
FUN_0003b384,242564,4,1,0,1,MAIN.EXE
FUN_00040024,262180,4,1,0,1,MAIN.EXE
FUN_0002443c,148540,1,1,0,1,MAIN.EXE
FUN_00026718,157464,1,1,0,1,MAIN.EXE
FUN_000267f8,157688,1,1,0,1,MAIN.EXE
FUN_000268f0,157936,1,1,0,1,MAIN.EXE
FUN_00026b10,158480,1,1,0,1,MAIN.EXE
FUN_00026b50,158544,1,1,0,1,MAIN.EXE
FUN_00026bec,158700,1,1,0,1,MAIN.EXE
FUN_00026e7c,159356,1,1,0,1,MAIN.EXE
FUN_0002704c,159820,1,1,0,1,MAIN.EXE
FUN_0002783c,161852,1,1,0,1,MAIN.EXE
FUN_00027d98,163224,1,1,0,1,MAIN.EXE
FUN_00027f00,163584,1,1,0,1,MAIN.EXE
FUN_00028020,163872,1,1,0,1,MAIN.EXE
FUN_00028144,164164,1,1,0,1,MAIN.EXE
FUN_00028704,165636,1,1,0,1,MAIN.EXE
FUN_000287d4,165844,1,1,0,1,MAIN.EXE
FUN_000294dc,169180,1,1,0,1,MAIN.EXE
FUN_00029928,170280,1,1,0,1,MAIN.EXE
FUN_0002995c,170332,1,1,0,1,MAIN.EXE
FUN_0002a218,172568,1,1,0,1,MAIN.EXE
FUN_0002a480,173184,1,1,0,1,MAIN.EXE
FUN_0002a598,173464,1,1,0,1,MAIN.EXE
FUN_0002a610,173584,1,1,0,1,MAIN.EXE
FUN_0002a630,173616,1,1,0,1,MAIN.EXE
FUN_0002a650,173648,1,1,0,1,MAIN.EXE
FUN_0002a950,174416,1,1,0,1,MAIN.EXE
FUN_0002c0e0,180448,1,1,0,1,MAIN.EXE
FUN_0002cd80,183680,1,1,0,1,MAIN.EXE
FUN_0002cda0,183712,1,1,0,1,MAIN.EXE
FUN_0002d1a4,184740,1,1,0,1,MAIN.EXE
FUN_0002d27c,184956,1,1,0,1,MAIN.EXE
FUN_0002d2dc,185052,1,1,0,1,MAIN.EXE
FUN_0002df40,188224,1,1,0,1,MAIN.EXE
FUN_0002df60,188256,1,1,0,1,MAIN.EXE
FUN_0002f6b0,194224,1,1,0,1,MAIN.EXE
FUN_000309b8,199096,1,1,0,1,MAIN.EXE
FUN_00030a18,199192,1,1,0,1,MAIN.EXE
FUN_00030a98,199320,1,1,0,1,MAIN.EXE
FUN_00030dc8,200136,1,1,0,1,MAIN.EXE
FUN_000318d8,202968,1,1,0,1,MAIN.EXE
FUN_00031910,203024,1,1,0,1,MAIN.EXE
FUN_00031a48,203336,1,1,0,1,MAIN.EXE
FUN_00031d28,204072,1,1,0,1,MAIN.EXE
FUN_000328d0,207056,1,1,0,1,MAIN.EXE
FUN_00032910,207120,1,1,0,1,MAIN.EXE
FUN_000336d0,210640,1,1,0,1,MAIN.EXE
FUN_00033704,210692,1,1,0,1,MAIN.EXE
FUN_00033744,210756,1,1,0,1,MAIN.EXE
FUN_00033764,210788,1,1,0,1,MAIN.EXE
FUN_00033a4c,211532,1,1,0,1,MAIN.EXE
FUN_00033b4c,211788,1,1,0,1,MAIN.EXE
FUN_0003415c,213340,1,1,0,1,MAIN.EXE
FUN_0003417c,213372,1,1,0,1,MAIN.EXE
FUN_0003451c,214300,1,1,0,1,MAIN.EXE
FUN_00034554,214356,1,1,0,1,MAIN.EXE
FUN_00034aa4,215716,1,1,0,1,MAIN.EXE
FUN_00034f54,216916,1,1,0,1,MAIN.EXE
FUN_00034f84,216964,1,1,0,1,MAIN.EXE
FUN_00035154,217428,1,1,0,1,MAIN.EXE
FUN_00035d1c,220444,1,1,0,1,MAIN.EXE
FUN_0003665c,222812,1,1,0,1,MAIN.EXE
FUN_00036754,223060,1,1,0,1,MAIN.EXE
FUN_00036afc,223996,1,1,0,1,MAIN.EXE
FUN_00036d5c,224604,1,1,0,1,MAIN.EXE
FUN_00036f34,225076,1,1,0,1,MAIN.EXE
FUN_00038020,229408,1,1,0,1,MAIN.EXE
FUN_00038604,230916,1,1,0,1,MAIN.EXE
FUN_00038e94,233108,1,1,0,1,MAIN.EXE
FUN_0003b2a0,242336,1,1,0,1,MAIN.EXE
FUN_0003b574,243060,1,1,0,1,MAIN.EXE
FUN_00007e10,32272,444,0,0,0,MAIN.EXE
FUN_000010b4,4276,332,0,0,0,MAIN.EXE
FUN_00021878,137336,196,0,0,0,MAIN.EXE
FUN_0001caa8,117416,164,0,0,0,MAIN.EXE
FUN_0001c2b4,115380,152,0,0,0,MAIN.EXE
FUN_0001d7b8,120760,152,0,0,0,MAIN.EXE
FUN_00009bb0,39856,116,0,0,0,MAIN.EXE
FUN_00006590,26000,108,0,0,0,MAIN.EXE
FUN_00016948,92488,108,0,0,0,MAIN.EXE
FUN_0001ad1c,109852,104,0,0,0,MAIN.EXE
FUN_0001c24c,115276,104,0,0,0,MAIN.EXE
FUN_0001e750,124752,100,0,0,0,MAIN.EXE
FUN_0000ea50,59984,76,0,0,0,MAIN.EXE
FUN_0001a248,107080,72,0,0,0,MAIN.EXE
FUN_0001b220,111136,68,0,0,0,MAIN.EXE
FUN_00021694,136852,68,0,0,0,MAIN.EXE
FUN_00023aa0,146080,68,0,0,0,MAIN.EXE
FUN_0001e2d4,123604,64,0,0,0,MAIN.EXE
FUN_0000505c,20572,60,0,0,0,MAIN.EXE
FUN_00006534,25908,52,0,0,0,MAIN.EXE
FUN_0001e11c,123164,52,0,0,0,MAIN.EXE
FUN_000064a4,25764,48,0,0,0,MAIN.EXE
FUN_000064d4,25812,48,0,0,0,MAIN.EXE
FUN_00006504,25860,48,0,0,0,MAIN.EXE
FUN_0001d9c8,121288,44,0,0,0,MAIN.EXE
FUN_00020e74,134772,44,0,0,0,MAIN.EXE
FUN_0001a320,107296,40,0,0,0,MAIN.EXE
FUN_0002336c,144236,36,0,0,0,MAIN.EXE
FUN_0001f5d4,128468,32,0,0,0,MAIN.EXE
FUN_00020634,132660,32,0,0,0,MAIN.EXE
FUN_0001dc64,121956,28,0,0,0,MAIN.EXE
FUN_0001dcf0,122096,28,0,0,0,MAIN.EXE
FUN_0001f5a8,128424,24,0,0,0,MAIN.EXE
FUN_00012c18,76824,20,0,0,0,MAIN.EXE
FUN_0001dd54,122196,20,0,0,0,MAIN.EXE
FUN_0001c9e8,117224,12,0,0,0,MAIN.EXE
FUN_0003003c,196668,12,0,0,0,MAIN.EXE
FUN_0001c97c,117116,8,0,0,0,MAIN.EXE
FUN_0001cba0,117664,8,0,0,0,MAIN.EXE
FUN_00023c68,146536,8,0,0,0,MAIN.EXE
FUN_000224dc,140508,4,0,0,0,MAIN.EXE
FUN_0002d170,184688,4,0,0,0,MAIN.EXE
FUN_0002f89c,194716,4,0,0,0,MAIN.EXE
FUN_00033fd0,212944,4,0,0,0,MAIN.EXE
FUN_00040028,262184,4,0,0,0,MAIN.EXE
